________________________________
________________________________
________________________________
________________________________
________________________________
________________________________
________________________________
____ccc_________________________
____ccc##################_______
____ccc_________________#_______
________________________#_______
________________________#_______
________________________#_______
_______________________!!!______
_______________________!!!______
________________________________
________________________________
________________________________
________________________________
________________________________
