_____________________________
____________ccccc____________
___cc___###vccccccc_____v____
__cccv###___cccc_ccc_________
___vcc____________v__________
___#______________#____v_____
___#______v_______#___vv_____
___##_________v___#_###______
____##__v_________###________
_____#__________###__________
_____##__ccc____#______v_____
______####vcv####____________
___!_____cccc___###__________
__________________###________
___________v________#________
____________________v____v___
___________________ccc_______
_________v__________c__v_____
_____________________________
_____________________________
