______________________________
____________ccccc_____________
__vccv__####ccccccc_____v_____
__cccc###___cccc_ccc__________
__vccv____________#___________
___#______________#____v______
___#______v_______#___vv______
___##_________v___#_###_______
____##__v_________###_________
_____#__________###___________
_____##__ccc____#______v______
______####ccc####_____________
___!_____cccc___###___________
__________________###_________
___________v________#_________
____________________c____v____
___________________ccc________
_________v__________c__v______
______________________________
______________________________
