________________________T_______
______________ccccc_____________
____vccv__####ccccccc_____v_____
____cccc###___cccc_ccc__________
____vccv____________#__T________
_____#_________T____#____v___T__
___T_#___T__v_______#___vv______
_____##_________v___#_###_______
_T____##__v___T_____###_________
_______#__________###___________
_______##__ccc____#______v____T_
________####ccc####_____________
_____!_____cccc___###___________
_______T____________###_________
_____________v________#_________
___T__________________c____v__T_
_________________T___ccc________
_____T_____v__________c__v______
_T____________T_________________
____________________________T___
