___________TTcTT_______________!
___________TTTTT_____________###
____________TTT______________#__
_____________T____________####__
____c_____________________#_____
____ccc___________________#_____
____cc########_________####_____
TT__#________#________##________
TTT_#________#________#_________
TT__#________##########_________
TTccc________#__________________
__cc##########__________________
__#__________#_______cccTTT_____
__#__________########cccccc_____
__#__________#_______ccc________
__#__________#__________________
_cccccccc#####__________________
_cccccccc_______________________
_cccccccc_______________________
________________________________
