________________________________
______________ccccc_____________
____vccv__####ccccccc_____v_____
____cccc###___cccc_ccc__________
____vccv____________#___________
_____#______________#____v______
_____#______v_______#___vv______
_____##_________v___#_###_______
______##__v_________###_________
_______#__________###___________
_______##__ccc____#______v______
________####ccc####_____________
_____!_____cccc___###___________
____________________###_________
_____________v________#_________
______________________c____v____
_____________________ccc________
___________v__________c__v______
________________________________
________________________________
