______________________________
____________ccccc_____________
___cc___###vccccccc_____v_____
__cccv###___cccc_ccc__________
___vcc____________v___________
___#______________#____v______
___#______v_______#___vv______
___##_________v___#_###_______
____##__v_________###_________
_____#__________###___________
_____##__ccc____#______v______
______####vcv####_____________
___!_____cccc___###___________
__________________###_________
___________v________#_________
____________________v____v____
___________________ccc________
_________v__________c__v______
______________________________
______________________________
